Jail
###############################################################################
###############################################################################
###############################################################################
###############################################################################
###############################################################################
###############################################################################
####################H                                ##########################
#################################################### ##########################
####################################################           ################
#################################################### ####      ################
#################################################### ####      ################
#################################################### ####      ################
#################################################### ##########################
#####################                                        ##################
#####################  ##### ###### ################ ##########################
#####################   ####   ####   ############## ##########################
#####################   ####   ####   ############## ##########################
#####################   ####   ####   ############## ##########################
####################################################                 ##########
####################################################                 ##########
####################################################                 ##########
###############################################################################
###############################################################################
###############################################################################
###############################################################################