Start
################
#       H      #
#¤¤            #
#   ¤          #
################