Town
##################################    ##########################################
##################################     #########################################
##################################     #########################################
###################                             ################################
#########                                               ########################
#########                                                    ###################
#######                                                      ###################
#######         ######                                         #################
#####           ######                                          ################
#####           ######             ####  #####                  ################
#######         ######             #         #                 #################
#####                              #         #                 #################
######                             ######### #                  ################
#####                              #         #                  ################
######                             #         #                 #################
########                           ###########                 #################
#########                                                     ##################
#########                                                     ##################
########                                                     ###################
########                                              ##########################
#########                                           ############################
####################     ###########      ######################################
################################################################################
################################################################################
################################################################################