Town
##################################....##########################################
##################################.....#########################################
##################################.....#########################################
###################.............................################################
#########...............................................########################
#########....................................................###################
#######......................................................###################
#######.........######.........................................#################
#####...........######..........................................################
#####...........######.............####..#####..................################
#######.........######.............#.........#.................#################
#####..............................#.........#.................#################
######.............................######### #..................################
#####..............................#.........#..................################
######............#.#.#............#.........#.................#################
########...........................###########.................#################
#########.........#...#.......................................##################
#########.....................................................##################
########..........#.#.#......................................###################
########..............................................##########################
#########...........................................############################
####################.....###########......######################################
################################################################################
################################################################################
################################################################################